20
24
385 385 385 385 385 385 385 385 385 385 385 385 385 385 385 385 385 385 385 385 
385 377 0 0 0 0 0 0 0 0 0 0 0 0 0 0 0 0 378 385 
385 0 0 0 0 0 0 0 0 0 0 0 0 0 0 0 0 0 0 385 
385 0 0 0 0 0 0 0 0 0 0 0 0 0 0 0 0 0 0 385 
385 0 0 0 0 0 0 0 0 0 0 0 0 0 0 366 367 0 0 385 
385 0 0 0 0 0 0 0 0 0 0 0 0 0 0 0 0 0 0 385 
385 0 0 0 0 25 0 0 0 0 0 0 366 367 0 0 0 0 0 385 
385 0 0 0 0 0 22 0 0 0 0 0 0 0 0 0 0 0 0 385 
385 362 0 29 0 25 20 0 20 0 0 0 0 0 0 0 0 0 0 385 
385 385 359 359 359 359 359 359 359 359 360 0 0 0 0 0 0 0 0 385 
385 388 388 388 388 388 388 388 388 388 377 0 0 364 365 0 0 0 0 385 
385 0 0 0 0 0 0 0 0 0 0 0 0 0 0 0 0 0 0 385 
385 0 0 0 0 0 0 0 0 0 0 0 0 0 0 0 0 0 0 385 
385 0 0 0 0 0 0 0 0 0 0 0 0 0 0 0 0 0 0 385 
385 0 0 0 0 0 0 0 0 0 0 0 0 0 0 0 364 365 0 385 
385 0 0 0 0 0 0 0 0 0 0 0 0 0 0 0 0 0 0 385 
385 0 0 0 0 0 0 0 0 0 0 0 0 0 0 0 0 0 0 385 
385 0 0 0 0 0 0 0 0 0 0 0 364 365 0 0 0 0 0 385 
385 0 0 0 0 0 0 0 0 0 0 0 0 0 0 0 0 0 0 385 
385 0 0 0 0 0 0 0 0 0 0 0 0 0 0 0 0 0 0 385 
385 0 0 0 0 0 0 0 0 0 0 0 0 0 0 364 365 0 0 385 
385 0 0 0 0 0 0 0 0 0 0 0 0 0 0 0 0 0 0 385 
385 362 10 9 0 0 0 20 10 0 0 0 0 9 0 0 0 0 0 385 
385 385 359 359 359 359 359 359 359 359 359 359 359 359 359 359 359 359 359 385 
